Hun_noun	TRUE
Jap_noun	TRUE
Jihadi_noun	TRUE
Yardie_noun	TRUE
abasement_noun	FALSE
abhor_verb	TRUE
abjure_verb	FALSE
abolish_verb	FALSE
abominable_adj	TRUE
abomination_noun	TRUE
abscond_verb	FALSE
absence_noun	FALSE
absurdity_noun	FALSE
abuse_noun	FALSE
abuse_verb	FALSE
abusive_adj	TRUE
accost_verb	FALSE
accuse_verb	FALSE
addiction_noun	FALSE
admonishment_noun	FALSE
admonition_noun	FALSE
adulteration_noun	FALSE
adverse_adj	FALSE
adversity_noun	FALSE
affectation_noun	FALSE
afflict_verb	FALSE
affront_noun	TRUE
affront_verb	FALSE
afraid_adj	FALSE
aggravation_noun	FALSE
aggression_noun	FALSE
aggressor_noun	FALSE
agitate_verb	FALSE
agitation_noun	FALSE
agitator_noun	TRUE
agonize_verb	FALSE
agonizing_adj	FALSE
ail_verb	FALSE
aimless_adj	FALSE
alarm_verb	FALSE
alarming_adj	FALSE
alienate_verb	FALSE
alienated_adj	FALSE
alienation_noun	FALSE
allegation_noun	FALSE
aloof_adj	TRUE
ambiguity_noun	FALSE
ambush_noun	TRUE
ambush_verb	FALSE
anarchist_noun	TRUE
anemic_adj	FALSE
anger_noun	FALSE
angry_adj	FALSE
animosity_noun	FALSE
annihilate_verb	TRUE
annoyance_noun	FALSE
anomaly_noun	FALSE
antagonism_noun	FALSE
antagonistic_adj	FALSE
antithetical_adj	FALSE
anxiety_noun	FALSE
anxiousness_noun	FALSE
ape_verb	FALSE
appal_verb	FALSE
appalled_adj	TRUE
apprehension_noun	FALSE
arcane_adj	FALSE
archaic_adj	FALSE
arrogance_noun	TRUE
arrogant_adj	TRUE
arse_noun	TRUE
ashamed_adj	TRUE
asinine_adj	TRUE
aspersion_noun	FALSE
ass_noun	TRUE
assassinate_verb	TRUE
assault_noun	TRUE
asshole_noun	TRUE
atrocity_noun	TRUE
attack_noun	FALSE
attack_verb	TRUE
audaciousness_noun	FALSE
audacity_noun	FALSE
austere_adj	FALSE
authoritarian_adj	FALSE
avarice_noun	TRUE
avaricious_adj	TRUE
aversion_noun	FALSE
avoid_verb	FALSE
avoidance_noun	FALSE
awful_adj	TRUE
awfulness_noun	TRUE
awkward_adj	TRUE
ax_verb	FALSE
backbiting_noun	TRUE
backward_adj	TRUE
bad_adj	FALSE
bait_verb	FALSE
balk_verb	FALSE
bampot_noun	TRUE
banal_adj	FALSE
bankrupt_verb	FALSE
bar_verb	FALSE
barbaric_adj	TRUE
barbarous_adj	TRUE
barren_adj	FALSE
bastard_noun	TRUE
battle_verb	FALSE
battleground_noun	FALSE
beaner_noun	TRUE
beast_noun	TRUE
beastly_adj	TRUE
beg_verb	FALSE
beguile_verb	FALSE
belittle_verb	TRUE
bellicose_adj	FALSE
belligerence_noun	FALSE
bemoan_verb	FALSE
berate_verb	FALSE
besiege_verb	FALSE
bestial_adj	TRUE
betray_verb	FALSE
betrayer_noun	TRUE
bewail_verb	FALSE
bewilder_verb	FALSE
bewildering_adj	FALSE
bewilderment_noun	FALSE
bicker_verb	FALSE
bickering_noun	FALSE
bint_noun	TRUE
bitch_noun	TRUE
biting_adj	FALSE
bitter_adj	TRUE
blab_verb	TRUE
blabber_verb	TRUE
blame_noun	FALSE
blame_verb	FALSE
blaspheme_verb	TRUE
blasphemy_noun	TRUE
blast_verb	FALSE
blasted_adj	FALSE
blather_verb	TRUE
blemish_noun	FALSE
blemish_verb	FALSE
blind_adj	TRUE
blind_verb	FALSE
blinding_adj	FALSE
blindside_verb	FALSE
bloodthirsty_adj	TRUE
blunt_adj	FALSE
blur_verb	FALSE
bogan_noun	TRUE
boggle_verb	FALSE
bogus_adj	TRUE
bollocks_noun	TRUE
bombard_verb	FALSE
bombardment_noun	TRUE
bondage_noun	FALSE
boner_noun	TRUE
bore_verb	FALSE
boredom_noun	FALSE
botch_verb	TRUE
bother_verb	FALSE
boycott_noun	FALSE
braggart_noun	TRUE
brainwash_verb	FALSE
bravado_noun	TRUE
brazenness_noun	FALSE
breach_noun	FALSE
break_verb	FALSE
bristle_verb	FALSE
broke_adj	FALSE
brood_verb	FALSE
brutality_noun	TRUE
brutalize_verb	FALSE
brute_noun	TRUE
buckra_noun	TRUE
bug_verb	FALSE
bugger_noun	TRUE
bullshit_noun	TRUE
bully_noun	TRUE
bungle_verb	FALSE
bungler_noun	TRUE
burdensome_adj	TRUE
burrhead_noun	TRUE
busy_adj	FALSE
butchery_noun	TRUE
cackle_verb	FALSE
cajole_verb	FALSE
cancer_noun	TRUE
cancerous_adj	TRUE
cannibalize_verb	TRUE
capricious_adj	TRUE
capriciousness_noun	TRUE
careless_adj	TRUE
carelessness_noun	TRUE
caricature_verb	FALSE
carnage_noun	TRUE
carp_verb	FALSE
cartoon_noun	FALSE
cash-strapped_adj	FALSE
castigate_verb	FALSE
catastrophe_noun	FALSE
cautious_adj	FALSE
celesbian_noun	TRUE
censure_verb	FALSE
chafe_verb	FALSE
challenge_verb	FALSE
chaos_noun	FALSE
charva_noun	TRUE
charver_noun	TRUE
chasten_verb	FALSE
chatter_verb	FALSE
chatterbox_noun	FALSE
chav_noun	TRUE
cheapen_verb	FALSE
cheat_noun	TRUE
cheat_verb	TRUE
cheerless_adj	FALSE
chide_verb	FALSE
chill_verb	FALSE
choke_verb	FALSE
chonky_noun	TRUE
chug_noun	TRUE
clamor_noun	FALSE
cliche_noun	TRUE
clog_verb	FALSE
close_adj	FALSE
clumsy_adj	TRUE
cock_noun	TRUE
cocky_adj	TRUE
coerce_verb	FALSE
coercion_noun	FALSE
cold_adj	TRUE
collapse_verb	FALSE
collide_verb	FALSE
collusion_noun	FALSE
combative_adj	FALSE
comical_adj	FALSE
commiserate_verb	FALSE
compel_verb	FALSE
complacent_adj	TRUE
compulsion_noun	FALSE
compulsive_adj	FALSE
conceit_noun	FALSE
conceited_adj	TRUE
concern_noun	FALSE
concern_verb	FALSE
concession_noun	FALSE
condemn_verb	FALSE
condescend_verb	FALSE
condescension_noun	FALSE
condolence_noun	FALSE
confound_verb	FALSE
confront_verb	FALSE
confrontation_noun	FALSE
confrontational_adj	FALSE
confuse_verb	FALSE
confused_adj	FALSE
congested_adj	FALSE
conspicuous_adj	FALSE
conspire_verb	FALSE
consternation_noun	FALSE
constraint_noun	FALSE
contempt_noun	TRUE
contend_verb	FALSE
contention_noun	FALSE
contort_verb	FALSE
contradict_verb	FALSE
contrariness_noun	FALSE
contravene_verb	FALSE
contrive_verb	FALSE
coolie_noun	TRUE
coon_noun	TRUE
cooter_noun	TRUE
corrode_verb	FALSE
corrosive_adj	TRUE
corrupt_verb	FALSE
counterproductive_adj	FALSE
cow_verb	FALSE
cracker_noun	TRUE
cramped_adj	FALSE
crap_noun	TRUE
crass_adj	TRUE
craze_noun	FALSE
craziness_noun	TRUE
crime_noun	FALSE
cringe_verb	TRUE
cripple_noun	TRUE
cripple_verb	TRUE
critical_adj	FALSE
criticize_verb	FALSE
cross_adj	FALSE
crude_adj	TRUE
cruel_adj	TRUE
crumble_verb	FALSE
crumple_verb	FALSE
crush_verb	FALSE
crushing_adj	FALSE
cuck_noun	TRUE
cunt_noun	TRUE
curse_verb	TRUE
cursed_adj	TRUE
cuss_verb	FALSE
cutthroat_adj	FALSE
cynicism_noun	FALSE
dago_noun	TRUE
damage_noun	FALSE
damage_verb	FALSE
damn_verb	TRUE
damnable_adj	FALSE
danger_noun	FALSE
dangle_verb	FALSE
darken_verb	FALSE
darkey_noun	TRUE
darkie_noun	TRUE
dawdle_verb	TRUE
dazed_adj	FALSE
deadlock_noun	FALSE
deadly_adj	FALSE
dearth_noun	FALSE
death_noun	FALSE
debacle_noun	FALSE
debate_verb	FALSE
debaucher_noun	FALSE
debauchery_noun	TRUE
debilitate_verb	FALSE
debility_noun	FALSE
decadent_adj	FALSE
deceitful_adj	TRUE
deceive_verb	FALSE
decline_noun	FALSE
decrease_noun	FALSE
decrease_verb	FALSE
decrepit_adj	FALSE
decrepitude_noun	FALSE
decry_verb	FALSE
defeat_noun	FALSE
defeat_verb	FALSE
defiance_noun	FALSE
deficiency_noun	FALSE
deform_verb	FALSE
defy_verb	FALSE
degenerate_verb	FALSE
degeneration_noun	FALSE
degrade_verb	FALSE
deign_verb	FALSE
dejection_noun	FALSE
delinquent_adj	TRUE
delirium_noun	FALSE
delude_verb	FALSE
deluded_adj	TRUE
deluge_noun	FALSE
demean_verb	TRUE
demise_noun	FALSE
demonize_verb	TRUE
demoralize_verb	FALSE
denigrate_verb	TRUE
denounce_verb	FALSE
deprecate_verb	FALSE
depress_verb	FALSE
depression_noun	FALSE
despair_noun	FALSE
despair_verb	FALSE
desperate_adj	FALSE
desperation_noun	FALSE
despondency_noun	FALSE
despondent_adj	FALSE
despotic_adj	TRUE
despotism_noun	TRUE
destabilisation_noun	FALSE
destitute_adj	FALSE
destitution_noun	FALSE
destroy_verb	TRUE
destroyer_noun	FALSE
destructive_adj	TRUE
deterrent_noun	FALSE
detest_verb	TRUE
detestable_adj	TRUE
devastate_verb	FALSE
devastated_adj	FALSE
devil_noun	TRUE
devilment_noun	FALSE
devilry_noun	FALSE
dhimmi_noun	TRUE
diabolic_adj	TRUE
diatribe_noun	TRUE
dick_noun	TRUE
dictatorial_adj	TRUE
differ_verb	FALSE
diffidence_noun	FALSE
dig_verb	FALSE
dilly-dally_verb	FALSE
dim_verb	FALSE
diminish_verb	FALSE
dinge_noun	TRUE
dink_noun	TRUE
dirt_noun	FALSE
disable_verb	FALSE
disabled_adj	FALSE
disadvantage_noun	FALSE
disaffected_adj	FALSE
disagreeable_adj	FALSE
disagreement_noun	FALSE
disallow_verb	FALSE
disapprove_verb	FALSE
disapproving_adj	FALSE
disarm_verb	FALSE
disastrous_adj	FALSE
disavow_verb	FALSE
disavowal_noun	FALSE
disbelieve_verb	FALSE
disbeliever_noun	TRUE
discomfit_verb	FALSE
disconcert_verb	FALSE
disconcerted_adj	FALSE
disconsolate_adj	FALSE
discontent_noun	FALSE
discontented_adj	FALSE
discord_noun	FALSE
discordance_noun	FALSE
discourage_verb	FALSE
discouragement_noun	FALSE
discouraging_adj	TRUE
discredit_verb	FALSE
discriminate_verb	FALSE
discrimination_noun	FALSE
disdainful_adj	TRUE
disgraceful_adj	TRUE
disgruntled_adj	FALSE
disgust_noun	FALSE
disgust_verb	TRUE
disgusted_adj	TRUE
dishonest_adj	TRUE
dishonesty_noun	TRUE
dishonor_verb	TRUE
disillusion_noun	TRUE
disillusion_verb	FALSE
disillusioned_adj	FALSE
disinclination_noun	FALSE
disintegrate_verb	TRUE
disintegration_noun	FALSE
disinterest_noun	FALSE
disloyalty_noun	TRUE
dismal_adj	TRUE
dismay_verb	FALSE
disown_verb	FALSE
disparage_verb	FALSE
dispensable_adj	FALSE
dispirited_adj	FALSE
dispiriting_adj	FALSE
displeasure_noun	FALSE
dispute_verb	FALSE
disputed_adj	FALSE
disquieting_adj	FALSE
disrespect_verb	TRUE
disrespectful_adj	TRUE
disrupt_verb	FALSE
disruptive_adj	FALSE
dissatisfaction_noun	FALSE
dissatisfied_adj	FALSE
dissemble_verb	FALSE
dissent_noun	FALSE
dissenter_noun	FALSE
dissolution_noun	FALSE
dissonance_noun	FALSE
distasteful_adj	TRUE
distort_verb	FALSE
distortion_noun	FALSE
distract_verb	FALSE
distraction_noun	FALSE
distress_verb	FALSE
distressing_adj	FALSE
distrust_verb	FALSE
disturb_verb	FALSE
disturbing_adj	FALSE
div_noun	TRUE
divide_verb	FALSE
divided_adj	FALSE
division_noun	FALSE
divisive_adj	FALSE
divisiveness_noun	FALSE
divorce_noun	FALSE
doddering_adj	FALSE
dominance_noun	FALSE
dominate_verb	FALSE
domination_noun	FALSE
doubt_noun	FALSE
douchbag_noun	TRUE
downfall_noun	FALSE
downgrade_verb	FALSE
downhearted_adj	FALSE
dragon_noun	TRUE
drain_noun	TRUE
dread_noun	FALSE
drought_noun	FALSE
dubious_adj	TRUE
dud_noun	TRUE
dullard_noun	TRUE
dumb_adj	TRUE
dumbass_noun	TRUE
dummy_noun	TRUE
dump_noun	FALSE
dunce_noun	TRUE
dupe_verb	TRUE
dusty_adj	FALSE
dyke_noun	TRUE
earsplitting_adj	TRUE
eccentricity_noun	FALSE
effrontery_noun	TRUE
ego_noun	FALSE
egomania_noun	TRUE
egotism_noun	TRUE
egotistical_adj	TRUE
ejaculate_verb	FALSE
eliminate_verb	FALSE
elimination_noun	FALSE
emasculate_verb	FALSE
embarrassing_adj	TRUE
embarrassment_noun	TRUE
embattled_adj	FALSE
empathy_noun	FALSE
encroachment_noun	FALSE
endanger_verb	FALSE
enemy_noun	FALSE
engulf_verb	FALSE
enrage_verb	FALSE
enraged_adj	FALSE
enslave_verb	TRUE
entangle_verb	FALSE
entanglement_noun	FALSE
entrap_verb	FALSE
envious_adj	TRUE
envy_noun	TRUE
envy_verb	TRUE
epidemic_adj	FALSE
equivocal_adj	FALSE
eradicate_verb	FALSE
erase_verb	FALSE
err_verb	FALSE
errant_adj	FALSE
error_noun	FALSE
estranged_adj	FALSE
evasion_noun	FALSE
evil_adj	TRUE
evildoer_noun	TRUE
eviscerate_verb	TRUE
exacerbate_verb	FALSE
exacting_adj	FALSE
exaggerate_verb	FALSE
exasperate_verb	FALSE
excessive_adj	FALSE
exclude_verb	FALSE
excuse_noun	FALSE
excuse_verb	FALSE
exhaust_verb	FALSE
exile_verb	FALSE
expel_verb	FALSE
exploitation_noun	TRUE
explosive_adj	FALSE
exterminate_verb	TRUE
extreme_adj	FALSE
extremism_noun	FALSE
eyetie_noun	TRUE
fabricate_verb	TRUE
fag_noun	TRUE
faggot_noun	TRUE
fail_verb	TRUE
fall_verb	FALSE
false_adj	FALSE
falter_verb	FALSE
famine_noun	FALSE
famished_adj	FALSE
fanatical_adj	FALSE
fanny_noun	TRUE
fart_noun	TRUE
fart_verb	TRUE
fascism_noun	FALSE
fatalistic_adj	TRUE
fault_verb	FALSE
faulty_adj	FALSE
fear_verb	FALSE
feeble_adj	TRUE
feign_verb	FALSE
feint_noun	FALSE
felon_noun	TRUE
felonious_adj	TRUE
fetid_adj	TRUE
fiasco_noun	FALSE
fiat_noun	FALSE
fib_noun	FALSE
fibber_noun	TRUE
fickle_adj	FALSE
fictional_adj	FALSE
fidget_verb	FALSE
fidgety_adj	FALSE
fiend_noun	TRUE
figurehead_noun	FALSE
filthy_adj	TRUE
finagle_verb	FALSE
finocchio_noun	TRUE
flak_noun	FALSE
flaky_adj	TRUE
flamer_noun	TRUE
flashy_adj	FALSE
flaunt_verb	FALSE
flaw_noun	FALSE
fleeting_adj	FALSE
flid_noun	TRUE
flimflam_noun	FALSE
flirt_verb	FALSE
flounder_verb	FALSE
flout_verb	FALSE
fluster_verb	FALSE
fool_verb	FALSE
foolishness_noun	TRUE
forbidden_adj	FALSE
force_verb	FALSE
forceful_adj	FALSE
formidable_adj	FALSE
foul_verb	TRUE
foulness_noun	TRUE
fracture_verb	FALSE
frantic_adj	FALSE
fraudulent_adj	TRUE
frazzled_adj	FALSE
freak_verb	FALSE
freakish_adj	TRUE
frenzy_noun	FALSE
fret_verb	FALSE
fretful_adj	FALSE
frighten_verb	FALSE
frigid_adj	TRUE
frocio_noun	TRUE
frown_noun	FALSE
frustrate_verb	FALSE
frustrating_adj	FALSE
frustration_noun	FALSE
fuck_noun	TRUE
fuck_verb	TRUE
fudge_noun	FALSE
fulminate_verb	FALSE
fumble_verb	FALSE
fury_noun	FALSE
fuss_verb	FALSE
gainsay_verb	FALSE
gall_verb	FALSE
gamble_noun	FALSE
gamble_verb	FALSE
gape_verb	FALSE
gauche_adj	TRUE
gaudy_adj	FALSE
geezer_noun	TRUE
genocide_noun	TRUE
gibber_verb	TRUE
ginger_noun	TRUE
ginzo_noun	TRUE
gippo_noun	TRUE
glare_verb	FALSE
glaring_adj	FALSE
gloomy_adj	FALSE
gloss_verb	FALSE
glower_verb	FALSE
goad_verb	FALSE
gobber_noun	TRUE
goof_noun	FALSE
goof_verb	TRUE
gook_noun	TRUE
gossip_noun	TRUE
gossip_verb	TRUE
graceless_adj	TRUE
graft_noun	FALSE
grave_adj	FALSE
greaseball_noun	TRUE
greed_noun	TRUE
grievance_noun	FALSE
grill_verb	FALSE
grimace_verb	TRUE
grind_noun	FALSE
gringo_noun	TRUE
gripe_verb	FALSE
groid_noun	TRUE
grotesque_adj	TRUE
grouch_noun	TRUE
grouchy_adj	TRUE
grouse_verb	FALSE
growl_verb	FALSE
grudge_verb	FALSE
gruesome_adj	TRUE
gubba_noun	TRUE
guilt_noun	FALSE
guilty_adj	FALSE
gurrier_noun	TRUE
gyp_noun	TRUE
gyppo_noun	TRUE
haggle_verb	FALSE
hairyback_noun	TRUE
halfhearted_adj	TRUE
halfrican_noun	TRUE
hallucination_noun	FALSE
hamper_verb	FALSE
handicapped_adj	FALSE
haphazard_adj	TRUE
harangue_verb	FALSE
hard_adj	FALSE
harden_verb	FALSE
harmful_adj	FALSE
harridan_noun	TRUE
haste_noun	FALSE
hate_verb	TRUE
hateful_adj	TRUE
hater_noun	TRUE
haunt_verb	FALSE
haunting_adj	FALSE
hayseed_noun	TRUE
hazard_verb	FALSE
hazy_adj	FALSE
heartless_adj	TRUE
heartrending_adj	FALSE
heathen_noun	TRUE
heavy-handed_adj	TRUE
heckle_verb	TRUE
heeb_noun	TRUE
heedless_adj	FALSE
hegemony_noun	FALSE
heresy_noun	FALSE
heretical_adj	TRUE
hesitant_adj	FALSE
hick_noun	TRUE
hillbilly_noun	TRUE
hinder_verb	FALSE
hindrance_noun	FALSE
hoax_verb	TRUE
hobble_verb	FALSE
hoe_noun	TRUE
honky_noun	TRUE
hoodwink_verb	FALSE
hopeless_adj	TRUE
hopelessness_noun	FALSE
horrendous_adj	TRUE
horrid_adj	TRUE
horror_noun	FALSE
hostage_noun	FALSE
hostilities_noun	FALSE
huckster_noun	TRUE
humiliate_verb	TRUE
humping_noun	TRUE
hurt_verb	TRUE
hustler_noun	TRUE
hypocrite_noun	TRUE
hysterics_noun	FALSE
idiocy_noun	TRUE
idiot_noun	TRUE
idle_adj	FALSE
ignominious_adj	FALSE
ignominy_noun	FALSE
ignorant_adj	TRUE
ignore_verb	FALSE
ikey_noun	TRUE
ill-conceived_adj	FALSE
illicit_adj	FALSE
illusion_noun	FALSE
imbalance_noun	FALSE
imbecile_noun	TRUE
imbroglio_noun	FALSE
immaterial_adj	FALSE
immoral_adj	TRUE
immorality_noun	TRUE
impair_verb	FALSE
impasse_noun	FALSE
impeach_verb	FALSE
impede_verb	FALSE
imperfect_adj	FALSE
imperil_verb	FALSE
imperious_adj	TRUE
impermissible_adj	FALSE
impersonal_adj	FALSE
impertinent_adj	TRUE
impetuous_adj	FALSE
impiety_noun	TRUE
implacable_adj	FALSE
implicate_verb	FALSE
impolitic_adj	FALSE
importunate_adj	FALSE
importune_verb	FALSE
impose_verb	FALSE
imposition_noun	FALSE
impoverish_verb	FALSE
impoverished_adj	FALSE
impractical_adj	FALSE
imprecise_adj	FALSE
improbable_adj	FALSE
imprudence_noun	FALSE
impugn_verb	FALSE
impulsive_adj	FALSE
impurity_noun	FALSE
inaccessible_adj	FALSE
inapt_adj	FALSE
incendiary_adj	FALSE
incense_verb	FALSE
incitement_noun	FALSE
incivility_noun	FALSE
inclement_adj	FALSE
incoherence_noun	FALSE
incomparable_adj	FALSE
incompetence_noun	TRUE
incomprehensible_adj	FALSE
incomprehension_noun	FALSE
inconceivable_adj	FALSE
inconsiderate_adj	TRUE
inconsistency_noun	FALSE
inconsistent_adj	FALSE
inconsolable_adj	FALSE
inconvenience_noun	FALSE
incorrect_adj	FALSE
incorrigible_adj	TRUE
inculcate_verb	FALSE
indecency_noun	FALSE
indefensible_adj	FALSE
indeterminate_adj	FALSE
indignation_noun	FALSE
indignity_noun	FALSE
indiscreet_adj	FALSE
indiscretion_noun	FALSE
indiscriminate_adj	FALSE
indulge_verb	FALSE
inefficacy_noun	FALSE
inefficiency_noun	FALSE
ineptitude_noun	TRUE
inequality_noun	FALSE
inequitable_adj	FALSE
inertia_noun	FALSE
inessential_adj	FALSE
inevitable_adj	FALSE
inexact_adj	FALSE
inexcusable_adj	FALSE
inexperienced_adj	FALSE
inexpert_adj	FALSE
infamous_adj	FALSE
inferior_adj	FALSE
infernal_adj	FALSE
infidel_noun	TRUE
infiltrator_noun	TRUE
inflammatory_adj	FALSE
infraction_noun	FALSE
infringe_verb	FALSE
infringement_noun	FALSE
inglorious_adj	FALSE
ingrate_noun	TRUE
inhibit_verb	FALSE
inhibition_noun	FALSE
inhospitality_noun	TRUE
inhumanity_noun	TRUE
inimical_adj	FALSE
iniquity_noun	FALSE
injun_noun	TRUE
injure_verb	FALSE
injury_noun	FALSE
injustice_noun	FALSE
innuendo_noun	FALSE
inordinate_adj	FALSE
insane_adj	TRUE
insanity_noun	TRUE
insecurity_noun	FALSE
insensible_adj	FALSE
insignificance_noun	FALSE
insignificant_adj	FALSE
insincerity_noun	TRUE
insinuate_verb	FALSE
instigate_verb	FALSE
instigator_noun	FALSE
insubordinate_adj	TRUE
insufferable_adj	TRUE
insufficient_adj	FALSE
insult_noun	TRUE
insulting_adj	TRUE
insurmountable_adj	FALSE
insurrection_noun	FALSE
interference_noun	FALSE
intermittent_adj	FALSE
intimidate_verb	TRUE
intimidating_adj	FALSE
intimidation_noun	TRUE
intractable_adj	FALSE
intransigence_noun	FALSE
intrude_verb	TRUE
intrusive_adj	FALSE
invader_noun	FALSE
invalid_adj	FALSE
invasive_adj	FALSE
invective_noun	TRUE
invidious_adj	TRUE
irk_verb	FALSE
irony_noun	FALSE
irreparable_adj	FALSE
irrepressible_adj	FALSE
irreverence_noun	FALSE
irreverent_adj	FALSE
irreversible_adj	FALSE
irritant_noun	TRUE
irritate_verb	FALSE
isolate_verb	FALSE
isolated_adj	FALSE
ivory_noun	TRUE
jagoff_noun	TRUE
jealous_adj	TRUE
jeer_verb	TRUE
jeopardize_verb	FALSE
jerk_noun	TRUE
jigaboo_noun	TRUE
jittery_adj	FALSE
joker_noun	FALSE
jumpy_adj	FALSE
juvenile_adj	FALSE
kaput_adj	FALSE
keen_verb	FALSE
kick_noun	TRUE
kike_noun	TRUE
kill_verb	TRUE
killer_noun	TRUE
knock_noun	FALSE
knock_verb	FALSE
kook_noun	TRUE
kooky_adj	TRUE
kraut_noun	TRUE
kyke_noun	TRUE
lackadaisical_adj	TRUE
laconic_adj	FALSE
lambast_verb	FALSE
languor_noun	FALSE
lapse_noun	FALSE
last-ditch_adj	FALSE
latrino_noun	TRUE
laughter_noun	FALSE
lawless_adj	FALSE
lax_adj	FALSE
lech_noun	FALSE
lecher_noun	TRUE
lechery_noun	TRUE
lecture_verb	FALSE
leer_verb	TRUE
lesbo_noun	TRUE
lethal_adj	FALSE
lethargy_noun	FALSE
lewd_adj	TRUE
lewdness_noun	TRUE
lezzie_noun	TRUE
liable_adj	FALSE
licentious_adj	TRUE
lie_verb	TRUE
lifeless_adj	FALSE
loath_adj	FALSE
loathing_noun	FALSE
loathsome_adj	TRUE
lonely_adj	FALSE
loophole_noun	FALSE
loot_verb	FALSE
loser_noun	TRUE
lousy_adj	TRUE
loveless_adj	FALSE
lubra_noun	TRUE
lugubrious_adj	FALSE
lukewarm_adj	FALSE
lull_verb	FALSE
lurch_verb	FALSE
lurid_adj	TRUE
lurk_verb	TRUE
madman_noun	TRUE
madness_noun	TRUE
maggot_noun	TRUE
malady_noun	FALSE
malaise_noun	FALSE
maliciousness_noun	TRUE
malign_adj	FALSE
malign_verb	TRUE
malodorous_adj	TRUE
maneuver_noun	FALSE
mangle_verb	FALSE
manipulative_adj	TRUE
mar_verb	FALSE
marginal_adj	FALSE
massacre_verb	TRUE
mawkish_adj	FALSE
melodramatic_adj	FALSE
menace_noun	FALSE
merciless_adj	TRUE
mere_adj	FALSE
messy_adj	FALSE
midget_noun	TRUE
militancy_noun	FALSE
mind_verb	FALSE
misbegotten_adj	FALSE
misbehave_verb	FALSE
miscalculate_verb	FALSE
miscalculation_noun	FALSE
mischief_noun	FALSE
miser_noun	TRUE
miserly_adj	FALSE
misery_noun	FALSE
misfortune_noun	FALSE
misinform_verb	FALSE
misinterpret_verb	FALSE
misjudge_verb	FALSE
mislead_verb	FALSE
misleading_adj	FALSE
mismanage_verb	FALSE
misread_verb	FALSE
misreading_noun	FALSE
misrepresent_verb	FALSE
misstatement_noun	FALSE
mistrust_noun	FALSE
mistrustful_adj	FALSE
misuse_verb	FALSE
moan_verb	FALSE
mock_verb	FALSE
mockery_noun	TRUE
molest_verb	TRUE
molestation_noun	TRUE
mong_noun	TRUE
monotonous_adj	FALSE
monster_noun	TRUE
mook_noun	TRUE
moon_verb	FALSE
mope_verb	TRUE
moribund_adj	FALSE
moron_noun	TRUE
mortification_noun	FALSE
motherfucker_noun	TRUE
motionless_adj	FALSE
mourner_noun	FALSE
muddle_verb	FALSE
muddy_adj	FALSE
mudslinging_noun	TRUE
muff_noun	TRUE
mulato_noun	TRUE
murder_noun	TRUE
murder_verb	TRUE
mutt_noun	TRUE
muzzie_noun	TRUE
mysterious_adj	FALSE
mystery_noun	FALSE
mystify_verb	FALSE
myth_noun	FALSE
nacho_noun	TRUE
nag_verb	TRUE
nagging_adj	TRUE
nastiness_noun	TRUE
nasty_adj	TRUE
nauseate_verb	FALSE
nebulous_adj	FALSE
need_noun	FALSE
need_verb	FALSE
needy_adj	FALSE
nefarious_adj	TRUE
negation_noun	FALSE
neglect_verb	FALSE
negligence_noun	TRUE
negligent_adj	TRUE
negro_noun	TRUE
nervous_adj	FALSE
nervousness_noun	FALSE
nettle_verb	FALSE
nigger_noun	TRUE
niggle_verb	FALSE
nightmare_noun	FALSE
niglet_noun	TRUE
noisy_adj	FALSE
nonsense_noun	TRUE
notorious_adj	FALSE
nuisance_noun	TRUE
numb_verb	FALSE
nutsack_noun	TRUE
object_verb	FALSE
objection_noun	FALSE
oblique_adj	FALSE
obliterate_verb	TRUE
obscene_adj	TRUE
obscenity_noun	TRUE
obsess_verb	TRUE
obsession_noun	FALSE
obsessiveness_noun	TRUE
obsolete_adj	FALSE
obstacle_noun	FALSE
obstruct_verb	FALSE
ocker_noun	TRUE
oddity_noun	FALSE
ofay_noun	TRUE
offence_noun	FALSE
officious_adj	TRUE
omission_noun	FALSE
omit_verb	FALSE
one-sided_adj	FALSE
onslaught_noun	TRUE
opinionated_adj	FALSE
oppress_verb	FALSE
ostracize_verb	FALSE
outburst_noun	FALSE
outcry_noun	FALSE
outlaw_noun	FALSE
outmoded_adj	FALSE
outrage_verb	FALSE
outrageousness_noun	TRUE
overact_verb	FALSE
overdo_verb	FALSE
overemphasize_verb	FALSE
overplay_verb	FALSE
overpower_verb	FALSE
overrun_verb	FALSE
overshadow_verb	FALSE
oversimplification_noun	FALSE
oversized_adj	FALSE
overstatement_noun	FALSE
overthrow_verb	FALSE
overturn_verb	FALSE
overwhelm_verb	FALSE
overzealous_adj	TRUE
paki_noun	TRUE
paleface_noun	TRUE
pan_verb	FALSE
pandemonium_noun	FALSE
panic_noun	FALSE
panic_verb	FALSE
pansy_noun	TRUE
paradoxical_adj	FALSE
paranoia_noun	TRUE
paranoid_adj	TRUE
parody_verb	FALSE
partisan_noun	FALSE
passe_adj	FALSE
passiveness_noun	FALSE
payback_noun	FALSE
peculiar_adj	FALSE
peeved_adj	FALSE
peevish_adj	TRUE
penalize_verb	FALSE
penalty_noun	FALSE
penis_noun	TRUE
perfidious_adj	FALSE
perfunctory_adj	TRUE
peril_noun	FALSE
peripheral_adj	FALSE
perish_verb	TRUE
perplexity_noun	FALSE
perturbed_adj	FALSE
perverse_adj	TRUE
perversion_noun	TRUE
pervert_verb	FALSE
perverted_adj	TRUE
pessimism_noun	FALSE
petrify_verb	FALSE
phobia_noun	FALSE
phobic_adj	FALSE
pillage_verb	FALSE
pillory_verb	FALSE
pinch_noun	FALSE
pique_verb	FALSE
piss_verb	TRUE
pittance_noun	FALSE
pity_noun	FALSE
plagiarize_verb	FALSE
plague_noun	TRUE
plebeian_adj	FALSE
plight_noun	FALSE
plot_verb	FALSE
plunder_verb	FALSE
pogue_noun	TRUE
poisonous_adj	TRUE
polack_noun	TRUE
pollute_verb	FALSE
pommy_noun	TRUE
pompous_adj	TRUE
pout_verb	TRUE
powerless_adj	FALSE
prate_verb	FALSE
pratfall_noun	FALSE
prattle_verb	TRUE
prejudge_verb	FALSE
prejudicial_adj	TRUE
preoccupy_verb	FALSE
presume_verb	FALSE
presumptuous_adj	TRUE
pretence_noun	FALSE
pretentious_adj	TRUE
prevaricate_verb	FALSE
pricey_adj	FALSE
prick_noun	TRUE
primitive_noun	FALSE
prisoner_noun	FALSE
problem_noun	FALSE
problematic_adj	FALSE
procrastinate_verb	FALSE
profane_adj	TRUE
prohibitive_adj	FALSE
propaganda_noun	FALSE
propagandize_verb	FALSE
protest_noun	FALSE
provocation_noun	FALSE
provoke_verb	FALSE
pry_verb	TRUE
pullock_noun	TRUE
punish_verb	FALSE
punishable_adj	FALSE
pussy_noun	TRUE
puzzle_verb	FALSE
puzzlement_noun	FALSE
puzzling_adj	FALSE
quandary_noun	FALSE
quarrel_verb	FALSE
quash_verb	FALSE
queer_adj	TRUE
questionable_adj	FALSE
quibble_verb	FALSE
quit_verb	FALSE
racism_noun	FALSE
rack_verb	FALSE
radical_adj	FALSE
radicalization_noun	FALSE
rage_verb	FALSE
ragged_adj	FALSE
raghead_noun	TRUE
raging_adj	FALSE
rail_verb	FALSE
rampage_verb	FALSE
rampant_adj	FALSE
rancor_noun	FALSE
rant_noun	FALSE
rant_verb	TRUE
rationalize_verb	FALSE
ravage_verb	FALSE
rebuff_verb	FALSE
rebuke_verb	FALSE
recalcitrant_adj	TRUE
recant_verb	FALSE
recession_noun	FALSE
recklessness_noun	TRUE
recoil_verb	FALSE
redneck_noun	TRUE
refuse_verb	FALSE
regret_verb	FALSE
relapse_verb	FALSE
relentless_adj	FALSE
remorse_noun	FALSE
remorseful_adj	FALSE
remorseless_adj	TRUE
renounce_verb	FALSE
renunciation_noun	FALSE
repel_verb	FALSE
reprehensible_adj	TRUE
repression_noun	FALSE
reprimand_verb	FALSE
reproach_verb	FALSE
reproachful_adj	FALSE
reprove_verb	FALSE
repudiate_verb	FALSE
repudiation_noun	FALSE
repugnance_noun	FALSE
repulse_verb	FALSE
resentful_adj	FALSE
resentment_noun	FALSE
restrict_verb	FALSE
restricted_adj	FALSE
restriction_noun	FALSE
restrictive_adj	FALSE
retaliate_verb	FALSE
retard_noun	TRUE
retire_verb	FALSE
retract_verb	FALSE
revenge_noun	FALSE
revenge_verb	FALSE
revengeful_adj	TRUE
revile_verb	TRUE
revoke_verb	FALSE
revolt_verb	FALSE
revulsion_noun	FALSE
rhetoric_noun	FALSE
ridicule_noun	TRUE
rigorous_adj	FALSE
rile_verb	FALSE
rival_verb	FALSE
rot_noun	TRUE
rotten_adj	TRUE
rough_adj	FALSE
roundeye_noun	TRUE
rude_adj	TRUE
ruffian_noun	TRUE
ruffle_verb	FALSE
ruthlessness_noun	TRUE
sad_adj	FALSE
sadden_verb	FALSE
sadness_noun	FALSE
sag_verb	FALSE
sanctimonious_adj	TRUE
sarcasm_noun	FALSE
sass_noun	FALSE
satirize_verb	FALSE
savage_adj	TRUE
savage_verb	TRUE
scag_noun	TRUE
scandalize_verb	TRUE
scank_noun	TRUE
scar_noun	FALSE
scar_verb	FALSE
scarcity_noun	FALSE
scare_verb	FALSE
scared_adj	FALSE
scathing_adj	FALSE
scheming_adj	TRUE
schlong_noun	TRUE
schmuck_noun	TRUE
scold_verb	FALSE
scorn_verb	FALSE
scoundrel_noun	TRUE
scowl_verb	TRUE
screech_noun	FALSE
scum_noun	TRUE
second-class_adj	TRUE
sedentary_adj	FALSE
seedy_adj	TRUE
seethe_verb	FALSE
self-defeating_adj	FALSE
self-destructive_adj	FALSE
self-interested_adj	TRUE
seriousness_noun	FALSE
sermonize_verb	FALSE
servitude_noun	TRUE
shabby_adj	FALSE
shady_adj	TRUE
shaky_adj	FALSE
shallow_adj	FALSE
sham_adj	TRUE
shame_noun	TRUE
shame_verb	TRUE
shamelessness_noun	TRUE
shatter_verb	FALSE
shirk_verb	TRUE
shirker_noun	TRUE
shit_noun	TRUE
shitty_adj	TRUE
shock_verb	FALSE
shortchange_verb	FALSE
shrew_noun	FALSE
shriek_verb	FALSE
shrill_adj	FALSE
shrivel_verb	FALSE
shroud_verb	FALSE
shrug_verb	FALSE
shyster_noun	TRUE
sickness_noun	FALSE
sidetrack_verb	FALSE
siege_noun	FALSE
silly_adj	TRUE
skanger_noun	TRUE
skeptical_adj	FALSE
skepticism_noun	FALSE
sketchy_adj	TRUE
skimpy_adj	FALSE
skittish_adj	FALSE
slander_noun	TRUE
slander_verb	FALSE
slanderous_adj	TRUE
slant_noun	TRUE
slap_verb	TRUE
slaughter_verb	TRUE
sleazy_adj	TRUE
slight_noun	FALSE
slight_verb	FALSE
slothful_adj	TRUE
slow-moving_adj	FALSE
slow_adj	FALSE
sluggish_adj	TRUE
slump_noun	FALSE
slut_noun	TRUE
sly_adj	FALSE
smash_verb	FALSE
smokescreen_noun	FALSE
smother_verb	FALSE
smoulder_verb	FALSE
smug_adj	TRUE
smut_noun	TRUE
snarl_noun	FALSE
snarl_verb	FALSE
sneak_verb	FALSE
sneaky_adj	TRUE
sneer_noun	TRUE
sneer_verb	TRUE
snout_noun	TRUE
snowflake_noun	TRUE
sob_verb	FALSE
sober_adj	FALSE
sorrow_noun	FALSE
sorrowful_adj	FALSE
sorry_adj	FALSE
sour_adj	TRUE
spank_verb	FALSE
spick_noun	TRUE
spide_noun	TRUE
spigger_noun	TRUE
spite_noun	FALSE
spiteful_adj	TRUE
spitefulness_noun	TRUE
split_verb	FALSE
spoil_verb	TRUE
spook_verb	FALSE
spurn_verb	TRUE
sputter_verb	FALSE
squander_verb	FALSE
squash_verb	FALSE
squaw_noun	TRUE
stagger_verb	FALSE
stagnation_noun	FALSE
stale_adj	FALSE
startling_adj	FALSE
starvation_noun	FALSE
starve_verb	FALSE
stealing_noun	FALSE
steep_adj	FALSE
stench_noun	TRUE
stern_adj	FALSE
stigmatize_verb	FALSE
stink_noun	TRUE
stink_verb	TRUE
stinking_adj	TRUE
stodgy_adj	FALSE
storm_verb	FALSE
strange_adj	TRUE
stranger_noun	FALSE
strangle_verb	TRUE
stress_noun	FALSE
strident_adj	FALSE
struggle_noun	FALSE
stubborn_adj	TRUE
stumble_noun	FALSE
stumble_verb	FALSE
stump_verb	FALSE
stun_verb	FALSE
stunt_noun	FALSE
subordinate_noun	FALSE
subservience_noun	FALSE
substandard_adj	TRUE
subtract_verb	FALSE
subversion_noun	FALSE
subvert_verb	FALSE
succumb_verb	FALSE
sucker_noun	TRUE
suffering_noun	FALSE
suffocate_verb	FALSE
sugar-coated_adj	FALSE
sulk_verb	TRUE
sully_verb	FALSE
superficial_adj	FALSE
superficiality_noun	FALSE
suppression_noun	FALSE
supremacy_noun	FALSE
surrender_noun	FALSE
swagger_verb	TRUE
swear_verb	FALSE
swindle_verb	TRUE
symptom_noun	FALSE
taboo_adj	FALSE
taint_verb	FALSE
tainted_adj	FALSE
tangled_adj	FALSE
tantrum_noun	TRUE
tart_noun	TRUE
taunt_verb	TRUE
tease_verb	FALSE
tedious_adj	TRUE
temper_noun	FALSE
tempest_noun	FALSE
tense_adj	FALSE
tentative_adj	FALSE
tepid_adj	FALSE
terror_noun	FALSE
terrorism_noun	FALSE
terrorize_verb	FALSE
thankless_adj	FALSE
thirst_noun	FALSE
thoughtless_adj	TRUE
thrash_verb	FALSE
threat_noun	FALSE
threaten_verb	FALSE
throttle_verb	TRUE
throw_verb	FALSE
timidity_noun	FALSE
tiring_adj	FALSE
toil_verb	FALSE
toll_noun	FALSE
topple_verb	FALSE
torment_noun	TRUE
torment_verb	TRUE
tortuous_adj	FALSE
torture_noun	TRUE
torture_verb	TRUE
tortured_adj	FALSE
toughness_noun	FALSE
traduce_verb	FALSE
tragedy_noun	FALSE
traitor_noun	TRUE
tramp_noun	TRUE
trample_verb	FALSE
tranny_noun	TRUE
transgress_verb	FALSE
travesty_noun	TRUE
treasonous_adj	TRUE
trick_noun	FALSE
tricky_adj	FALSE
trivial_adj	FALSE
trivialize_verb	FALSE
trouble_verb	FALSE
troublesome_adj	FALSE
tumultuous_adj	FALSE
twat_noun	TRUE
twink_noun	TRUE
twist_noun	FALSE
twisted_adj	TRUE
tyrannical_adj	TRUE
ugliness_noun	TRUE
ugly_adj	TRUE
ultimatum_noun	FALSE
unable_adj	FALSE
unavailable_adj	FALSE
unbearable_adj	TRUE
unclear_adj	FALSE
uncomfortable_adj	FALSE
uncontrolled_adj	FALSE
underdog_noun	FALSE
underestimate_verb	FALSE
undetermined_adj	FALSE
unease_noun	FALSE
uneasiness_noun	FALSE
uneasy_adj	TRUE
uneconomical_adj	FALSE
unethical_adj	TRUE
uneven_adj	FALSE
unfaithful_adj	TRUE
unfavorable_adj	FALSE
unfeeling_adj	TRUE
unfounded_adj	FALSE
unfriendly_adj	FALSE
ungovernable_adj	FALSE
unhealthy_adj	TRUE
unilateralism_noun	FALSE
unjustified_adj	FALSE
unlawful_adj	FALSE
unlawfulness_noun	FALSE
unleash_verb	FALSE
unlicensed_adj	FALSE
unlikely_adj	FALSE
unlucky_adj	FALSE
unnecessary_adj	FALSE
unnerving_adj	FALSE
unpleasant_adj	FALSE
unpopular_adj	FALSE
unprecedented_adj	FALSE
unreasonable_adj	FALSE
unreliability_noun	FALSE
unruly_adj	TRUE
unsafe_adj	FALSE
unsettle_verb	FALSE
unsophisticated_adj	FALSE
unstable_adj	FALSE
unsteadiness_noun	FALSE
unsteady_adj	FALSE
unsupported_adj	FALSE
untenable_adj	FALSE
untimely_adj	FALSE
untrue_adj	FALSE
unwanted_adj	TRUE
unwarranted_adj	FALSE
unwieldy_adj	FALSE
unwillingness_noun	FALSE
unwise_adj	FALSE
unworthy_adj	TRUE
unyielding_adj	FALSE
upbraid_verb	FALSE
upheaval_noun	FALSE
uprising_noun	FALSE
uproarious_adj	FALSE
uproot_verb	FALSE
upset_verb	FALSE
urgency_noun	FALSE
usurp_verb	FALSE
usurper_noun	TRUE
vanish_verb	FALSE
vehement_adj	FALSE
vengeful_adj	TRUE
vengefulness_noun	FALSE
vex_verb	FALSE
viciousness_noun	TRUE
victimize_verb	FALSE
vile_adj	TRUE
vilify_verb	FALSE
violate_verb	FALSE
violation_noun	TRUE
violator_noun	FALSE
violent_adj	TRUE
viper_noun	TRUE
virulence_noun	FALSE
volatile_adj	FALSE
vomit_verb	TRUE
vulgar_adj	TRUE
wail_verb	FALSE
wane_verb	FALSE
wariness_noun	FALSE
warlike_adj	FALSE
warped_adj	TRUE
waste_noun	FALSE
waste_verb	TRUE
wasteful_adj	FALSE
wastefulness_noun	TRUE
wayward_adj	FALSE
weaken_verb	FALSE
weakness_noun	FALSE
weary_verb	FALSE
weep_verb	FALSE
wetback_noun	TRUE
whimper_verb	FALSE
whine_verb	TRUE
whore_noun	TRUE
widespread_adj	FALSE
wigger_noun	TRUE
wild_adj	FALSE
wilt_verb	FALSE
wily_adj	FALSE
wince_verb	FALSE
withhold_verb	FALSE
woe_noun	FALSE
woebegone_adj	FALSE
wolly_noun	TRUE
wop_noun	TRUE
worried_adj	FALSE
worry_noun	FALSE
worry_verb	FALSE
worsen_verb	FALSE
worthless_adj	TRUE
worthlessness_noun	FALSE
wound_noun	FALSE
wrangle_verb	FALSE
wreck_noun	TRUE
wreck_verb	TRUE
wrest_verb	FALSE
wrestle_verb	FALSE
wrong_verb	FALSE
wrongful_adj	FALSE
yarpie_noun	TRUE
yawn_noun	FALSE
yawn_verb	FALSE
yokel_noun	TRUE
zealot_noun	TRUE
zigabo_noun	TRUE
